- - - - - - - + + + + + + + +
- - - - - - - + - - - - - - -
- + - - - - - + + + + 2 - - -
- + - - + + + + - - - - - - -
- + + + + - - - - - - - - - -
- - - - + - - - + + + + - - -
+ + + - + + + - + - - + - - -
- - + + + - + + + - - - - - -
- - - - + - - - + - - - - - -
1 + + + + - - - - - - - - - -